NO ./path_to_the_north_texture.xpm
SO ./path_to_the_south_texture.xpm
EA  ./path_to_the_east_texture.xpm
WE ./path_to_the_west_texture.xpm

C 225,30,0

F 220,100,0

        1111111111111111111111111
        1000000000110000000000001
        1011000001110001000N00001
        100100010000000010000001
111111111011001001100000000000001
10000000001100000111111110011111
100001111111110111000000100011
111101111111110111010100100011
11000000110101011100000010001
10000000000000001100000010001
10000000000000001101010010001
110000011010100111101111000111
11110111 1110101 101111010001
11111111 1111111 111111111111