NO ./path_to_the_north_texture.xpm
SO ./path_to_the_south_texture.xpm
WE ./path_to_the_west_texture.xpm
EA ./path_to_the_east_texture.xpm

F 220,100,0
C 225,30,0

111111111111111
100000000000101
100001000000101
111100000010101
100000000010101
100000001N111101
100000000000001
100000000000001
111111000111101
100000000000001
111111111111111